100 100 100 100 100 100 100 100 100 100 100
100 0 0 0 0 0 0 0 0 0 100
100 3 2 2 3 0 3 2 2 3 100
100 1 1 1 1 0 1 1 1 1 100
100 1 1 1 1 0 1 1 1 1 100
100 3 2 2 3 0 3 2 2 3 100
100 1 1 1 1 0 1 1 1 1 100
100 1 1 1 1 0 1 1 1 1 100
1 1 1 1 1 1 1 1 1 1 1
0 0 0 0 0 0 0 0 0 0 0
0 0 0 0 0 0 0 0 0 0 0
0 0 0 0 0 0 0 0 0 0 0

