0 0 1 1 1 1 0 0 1 1 1 1 0 0 1 1 1 1 0 0
0 0 1 1 1 1 0 0 1 1 1 1 0 0 1 1 1 1 0 0
0 0 0 0 0 0 0 0 0 0 0 0 0 0 0 0 0 0 0 0
0 0 100 100 100 100 0 0 100 100 100 100 0 0 100 100 100 100 0 0
0 0 100 2 2 100 0 0 100 1 1 100 0 0 100 2 2 100 0 0
0 0 100 1 1 100 0 0 100 1 1 100 0 0 100 1 1 100 0 0
0 0 100 3 3 100 0 0 100 1 1 100 0 0 100 3 3 100 0 0
0 0 0 0 0 0 0 0 0 0 0 0 0 0 0 0 0 0 0 0
0 1 1 1 100 100 100 100 100 1 1 100 100 100 100 100 1 1 1 0
0 1 100 1 1 1 1 1 100 1 1 100 1 1 1 1 1 100 1 0
0 1 100 1 1 1 1 1 100 1 1 100 1 1 1 1 1 100 1 0
0 1 100 1 1 1 1 1 100 1 1 100 1 1 1 1 1 100 1 0
0 1 100 1 1 1 1 1 100 1 1 100 1 1 1 1 1 100 1 0
0 1 1 1 100 100 100 100 100 1 1 100 100 100 100 100 1 1 1 0
0 0 0 0 0 0 0 0 0 0 0 0 0 0 0 0 0 0 0 0
0 0 3 0 0 0 0 0 0 0 0 0 0 0 0 0 0 3 0 0
0 0 1 1 1 1 1 1 1 0 0 1 1 1 1 1 1 1 0 0
0 0 1 1 1 1 1 1 1 0 0 1 1 1 1 1 1 1 0 0
0 100 100 100 100 100 100 100 100 100 100 100 100 100 100 100 100 100 100 0
0 100 100 100 100 100 100 100 100 100 100 100 100 100 100 100 100 100 100 0