100 100 100 100 100 100 100 100 100 100 100
100 0 0 0 0 0 0 0 0 0 100
100 2 2 2 2 0 2 2 2 2 100
100 1 1 1 1 0 1 1 1 1 100
100 1 1 1 1 0 1 1 1 1 100
100 2 2 2 2 0 2 2 2 2 100
100 1 1 1 1 0 1 1 1 1 100
100 1 1 1 1 0 1 1 1 1 100
1 1 1 1 1 1 1 1 1 1 1

