100 100 100 100 100 100 100 100 100 100 100
100 1 1 1 1 0 1 1 1 1 100
100 2 2 2 2 0 2 2 2 2 100
100 3 3 3 3 0 3 3 3 3 100
100 1 1 1 1 0 1 1 1 1 100
100 2 2 2 2 0 2 2 2 2 100
100 3 3 3 3 0 3 3 3 3 100
100 1 1 1 1 0 1 1 1 1 100
1 1 1 1 1 1 1 1 1 1 1

