3 3 3 3 3 3 1 1 3 3 3 3 3 3
3 1 1 3 1 1 1 1 1 1 3 1 1 3
3 1 0 1 1 1 1 1 1 1 1 0 1 3
3 100 0 100 1 2 100 100 2 1 100 0 100 3
3 3 0 2 2 2 2 2 2 2 2 0 3 3
3 3 2 2 2 0 0 0 0 2 2 2 3 3
100 3 3 3 3 3 3 3 3 3 3 3 3 100
1 1 1 1 1 1 4 4 1 1 1 1 1 1
1 1 1 1 1 4 4 4 4 1 1 1 1 1
1 1 1 0 4 4 4 4 4 4 0 1 1 1
0 0 1 0 3 3 3 3 3 3 0 1 0 0
0 100 0 0 100 0 0 0 0 100 0 0 100 0
0 0 0 0 0 0 0 0 0 0 0 0 0 0
0 0 100 0 0 0 0 0 0 0 0 100 0 0